##########
PE.......#
#..C##B..#
#..#..#..#
#.#.BB.#.#
#...#....#
#####S####