##########
#E.......#
#.######.#
#.#....#.#
#.#.##.#.#
#...#....#
#####S####