##########
#E.......#
#..C##B..#
#..#..#..#
#.#.BB.#.#
#...#....#
#####S####