#############
#E...I....B.#
#..C##B.....#
#..#..#..O..#
#.#.BB.#....#
#...#..O..O.#
#####S#######